111111111111
1P0000y00001
1C0000000001
111111100001
1f0000000E01
1i0000C00001
111111111111