111111111111111
1C1000y0000rC01
101f11011111001
10100000a001001
1E00111110010C1
100i1CC000P0001
111111111111111