111111111111
1y1000C00001
1f0110010001
1000P0010001
1a10C00000r1
1010000C0111
101000000001
1i100C00C011
1000000000E1
111111111111