1111111111111111111
11C0000000000001C01
1C10001111110010101
10r1000y010011C0101
1000100P10001000001
1000010000001000101
10C0000100001000101
10000001a0000000101
1f00ECC1111111001i1
1111111111111111111