111111111111
1C0000y00001
110000000P01
111111100001
1f0000000E01
1i0000C00001
111111111111