111111111111111
1C1000y0000iC01
101a11011111001
10100000r001001
1E0f111110010C1
10001CC000P0001
111111111111111
