111111111111
1y1000C00001
100110010001
1000P0010001
1a10C00000r1
1010000C0111
101000000001
1i100C00C011
1000f00000E1
111111111111