11111111111111111111
11C00000000000011001
10100011111100110101
10r1000y010011010101
100010CP100010010001
10000100000010000101
10000001000010010101
10011111a00000010101
1f00E0011111110101i1
11111111111111111111
