11111111111111111111
11C00000000000011001
10100011111100110101
10i1000y010011010101
100010CP100010010001
10000100000010000101
100000r1000010010101
10011111a0000001C101
1f00E0011111110101C1
11111111111111111111