111111111111111
1CC0C1001Ei0001
100100101110101
1r1y100010001f1
111011100001111
1C0000P0Ca00001
111111111111111